0 0 0 1 0
1 0 0 1 0
0 0 1 1 0
1 0 0 1 0
0 1 0 0 0
0 0 0 0 0

// X=За, Y=ї­
[MAP]
sizeX=6
sizeY=5